#original alias
Thyroid	Thyroid cancer
BCL	B-Cell Lymphoma
Lung squamous cell	lung squamous cell carcinoma
BOCA	Bone Cancer
Neoplasm of lung	lung adenocarcinoma
BT	Biliary Tract Cancer
non-small cell lung cancer	non-small cell lung carcinoma
APML	Acute Promyelocytic Leukaemia
Advanced Solid Tumor	Cancer
LINC	Liver Cancer
RT	Rhabdoid Tumor
Malignant peripheral nerve sheat tumor	malignant peripheral nerve sheath tumor
salivary duct carcinoma	salivary gland carcinoma
UVM	Uveal Melanoma
Billiary tract	biliary tract neoplasm
L	Lung Cancer
lung	Lung Cancer
T Lymphoblastic Leukemia/Lymphoma	acute T cell leukemia
BTCA	Biliary Tract Cancer
Solid tumor	Cancer
Neoplasm of respiratory system	respiratory system cancer
PACA	Pancreatic Cancer
EOPC	Early Onset Prostate Cancer
BRCA	Breast Cancer
OV	Ovarian Cancer
OS	Osteosarcoma
KICH	Kidney Chromophobe
DLBC	Lymphoid Neoplasm Diffuse Large B-cell Lymphoma
GBM	Glioblastoma Multiforme
STAD	Stomach Adenocarcinoma
Neoplasm of breast	Breast Cancer
Non-small cell lung	non-small cell lung carcinoma
Neoplasm of colon	Neoplasm of the colon
WT	Wilms Tumor
AML	Acute Myeloid Leukemia
Acute myeloid leukaemia, disease	Acute Myeloid Leukemia
MALY	Lymphoma
Malignant Lymphoma	Lymphoma
Gastrointestinal stromal	Gastrointestinal stromal tumor
CER	cervical cancer
SKCM	Skin Cutaneous Melanoma
GACA	Gastric Cancer
SKCA	Skin Adenocarcinoma
Neoplasm of colorectum	rectal neoplasm
PRAD	Prostate Cancer
Tumour of prostate	Prostate Cancer
CLLE	Chronic Lymphocytic Leukemia
Chronic lymphoid leukaemia, disease	Chronic Lymphocytic Leukemia
Ovary	ovarian cancer
UCS	Uterine Carcinosarcoma
ESCA	Esophageal Cancer
COREAD	Colorectal adenocarcinoma
PAAD	Pancreatic Cancer
MELA	Skin Cancer
UC	bladder urachal urothelial carcinoma
ESAD	Esophageal Adenocarcinoma
ACC	Adrenocortical Carcinoma
Neoplasm of digestive system	gastrointestinal system cancer
READ	Rectum Adenocarcinoma
BCC	Basal cell carcinoma
UTCA	Uterine Cancer
All Solid Tumors	Cancer
Neoplasm of rectum	rectum cancer
CML - Chronic myeloid leukaemia	chronic myeloid leukemia
CCSK	Clear Cell Sarcoma of the Kidney
LIRI	Liver Cancer
HNSC	Head and Neck Squamous Cell Carcinoma
COCA	Colorectal Cancer
NBL	Neuroblastoma
UCEC	Uterine Corpus Endometrial Carcinoma
CH	Cholangiocarcinoma
LUSC	Lung Cancer
LICA	Liver Cancer
urothelial carcinoma	bladder urachal urothelial carcinoma
MM - Malignant melanoma of skin	skin melanoma
ALL	Acute Lymphoblastic Leukemia
ALL - Acute lymphoblastic leukaemia	Acute Lymphoblastic Leukemia
Any cancer type	Cancer
LMS	Soft tissue cancer
Solid tumors	Cancer
PAEN	Pancreatic Endocrine Neoplasms
RECA	Renal Cancer
LGG	Brain Lower Grade Glioma
THCA	Thyroid Cancer
BLCA	Bladder Cancer
PCPG	Pheochromocytoma and Paraganglioma
B Lymphoblastic Leukemia/Lymphoma	B-cell adult acute lymphocytic leukemia
Malignant tumor of breast	Breast Cancer
CESC	Cervical Squamous Cell Carcinoma
LIHM	Liver Cancer
THYM	Thymoma
CA - Carcinoma of breast	Breast Cancer
LIHC	Liver Hepatocellular Carcinoma
CHOL	Cholangiocarcinoma
TH	Thyroid Cancer
COAD	Colon Adenocarcinoma
ORCA	Oral Cancer
Diffuse Large B Cell Lymphoma	diffuse large B-cell lymphoma
CNS	central nervous system cancer
TGCT	Testicular Germ Cell Tumors
PTC - Papillary thyroid carcinoma	papillary thyroid carcinoma
LIAD	Benign Liver Tumour
MESO	Mesothelioma
CMDI	Chronic Myeloid Disorders
Malignant neoplastic disease	Cancer
Neoplasm of respiratory tract	respiratory system cancer
Carcinoma of ovary	ovarian cancer
SARC	Sarcoma
KIRP	Kidney Renal Papillary Cell Carcinoma
NKTL	Blood Cancer
LAML	Acute Myeloid Leukemia
All Tumors	Cancer
LUAD	Lung Adenocarcinoma
KIRC	Kidney Renal Clear Cell Carcinoma
PBCA	Pediatric Brain Cancer
BREAST-OVARIAN CANCER, FAMILIAL, SUSCEPTIBILITY TO, 1; BROVCA1 (604370	Breast Cancer
BREAST-OVARIAN CANCER, FAMILIAL, SUSCEPTIBILITY TO, 1; BROVCA1 (604370)	Breast Cancer
BREAST-OVARIAN CANCER, FAMILIAL, SUSCEPTIBILITY TO, 2; BROVCA2 (612555)	Breast Cancer
BREAST-OVARIAN CANCER, FAMILIAL, SUSCEPTIBILITY TO, 2; BROVCA2 (612555	Breast Cancer
Leukaemia	leukemia
HIV - Human immunodeficiency virus infection	human immunodeficiency virus infectious disease
HF - Heart failure	Heart failure
Plasmacytic myeloma	multiple myeloma
Ovarian Ca	Ovarian Cancer
Myeloproliferative disorder	myeloproliferative neoplasm
Diffuse malignant lymphoma - histiocytic	Diffuse lymphoma
Follicular non-Hodgkin lymphoma	non-Hodgkin lymphoma
MDS - Myelodysplastic syndrome	myelodysplastic syndrome
Grawitz tumor	Renal cell carcinoma
mCRC - Metastatic colorectal cancer	colorectal cancer
M4 - Acute myelomonocytic leukaemia	acute myeloid leukemia
Acute myeloid leukaemia with 11q23 abnormality	acute myeloid leukemia
Triple Negative Breast Cancer	triple-receptor negative breast cancer
Myelomonocytic leukaemia	myeloid leukemia
CA - Cancer of pancreas	Pancreatic Cancer
Metastasis from malignant melanoma of skin	skin melanoma
Non-small cell carcinoma of lung, TNM stage 4	non-small cell lung carcinoma
Renal tumour	kidney cancer
Local recurrence of malignant tumor of breast	breast cancer
Burkitt's tumour	Burkitt lymphoma
Diffuse non-Hodgkin's lymphoma, lymphoblastic	non-Hodgkin's lymphoma
Cancer of stomach	stomach cancer
Primary adenocarcinoma of colon	colon adenocarcinoma
Neoplasm of brain	brain cancer
Leukaemia in remission	leukemia
Philadelphia chromosome positive chronic myelogenous leukaemia	atypical chronic myeloid leukemia
Extranodal marginal zone B-cell lymphoma of mucosa-associated lymphoid tissue	marginal zone B-cell lymphoma
Chronic phase chronic myeloid leukemia	chronic myeloid leukemia
Diffuse non-Hodgkin's lymphoma, small cleaved cell	Burkitt lymphoma
BRAF mutated melanoma	melanoma
Myeloid leukemia in remission	acute myeloid leukemia
Acute myeloid leukemia in remission	acute myeloid leukemia
Tumour of fallopian tube	fallopian tube cancer
[M]Chronic myelomonocytic leukaemia	chronic myelomonocytic leukemia
MF - Myelofibrosis	myelofibrosis
Arteriosclerotic heart disease	arteriosclerotic cardiovascular disease
Peritoneal cancer	peritoneal mesothelioma
Neoplasm of esophagus	esophagus leiomyosarcoma
WaldenstrÃ¶m macroglobulinaemia	lymphoplasmacytic lymphoma
Hormone refractory prostate cancer	refractory hematologic cancer
T-cell lymphoma	peripheral T-cell lymphoma
Drug resistance to insulin	Insulin resistance
Mycotic disease	mycosis
Philadelphia chromosome negative chronic myelogenous leukaemia	atypical chronic myeloid leukemia
Primary adenocarcinoma of pancreas	pancreatic adenocarcinoma
Large cell anaplastic lymphoma	anaplastic large cell lymphoma
MI - Myocardial infarction	myocardial infarction
Tumour of urinary bladder	urinary bladder cancer
MF - Mycosis fungoides	mycosis
Metastasis from malignant tumour of pancreas	pancreas cancer
KRAS mutant colorectal cancer	colorectal cancer
SÃ©zary's disease	cutaneous T cell lymphoma
Neoplasm of nervous system	autonomic nervous system neoplasm
Neoplasm of central nervous system	central nervous system melanocytic neoplasm
FLT3 AML	acute myeloid leukemia
Neoplasm of endometrium	endometrial cancer
Non-small cell carcinoma of lung, TNM stage 3	non-small cell lung carcinoma
Primary malignant neoplasm of male breast	male breast cancer
Local recurrence of malignant tumour of colon	colon cancer
Osteomyelofibrosis	chronic idiopathic myelofibrosis
Astrocytic tumor of brain	brain stem astrocytic neoplasm
HER2-positive carcinoma of breast	breast carcinoma
CVA - Cerebrovascular accident	cerebrovascular disease
AAMD - Age related macular degeneration	age related macular degeneration
AD - Alzheimer's disease	Alzheimer's disease
Histiocytic leukemia	leukemia
Local recurrence of malignant tumor of rectum	rectum cancer
Neoplasm of oropharynx	oropharynx cancer
Neuroendocrine tumour	adult astrocytic tumour
Acute monocytoid leukaemia	acute leukemia
M2 - Acute myeloblastic leukemia with maturation	acute myeloid leukemia
M1 - Acute myeloblastic leukaemia without maturation	acute leukemia
Sarcoma of soft tissue	sarcoma
Secondary cancer of brain	brain cancer
Adult T-cell leukaemia	adult T-cell leukemia
Myelodysplastic syndrome: Refractory anaemia, without ringed sideroblasts, without excess blasts	Refractory anemia with ringed sideroblasts
Angioimmunoblastic T-cell lymphoma	peripheral T-cell lymphoma
Erythroleukaemia	 acute myelogenous leukemia
Tumour of postnasal space	adult astrocytic tumour
M0 - Acute myeloblastic leukemia - undifferentiated	acute promyelocytic leukemia
LRE - Leukaemic reticuloendotheliosis	intrapelvic lymph node leukemic reticuloendotheliosis
Refractory anaemia with excess blasts	anemia
Vaquez's disease	Primary Polycythemia
AF - Atrial fibrillation	atrial fibrillation
Neoplasm of larynx	Neoplasm of the larynx
Secondary malignant neoplasm of liver	liver cancer
Tumour of cervix	cervix carcinoma
Local recurrence of malignant tumor of prostate	prostate cancer
Idiopathic Parkinson's disease	Parkinson's disease
PLL - Prolymphocytic leukaemia	prolymphocytic leukemia
Carcinoma of peritoneum	peritoneum cancer
Neoplasm of hypopharynx	hypopharynx cancer
Myelodysplastic/myeloproliferative disease	myelodysplastic/myeloproliferative neoplasm
B-CLL - B-cell chronic lymphocytic leukemia	chronic lymphocytic leukemia
Intraductal carcinoma of breast	breast carcinoma
HD - Hodgkin's disease	Hodgkin's lymphoma
Mesothelioma	benign mesothelioma
Anaplastic astrocytoma of brain	astrocytoma
Chronic eosinophilic leukaemia	leukemia
Neoplasm of abdominal esophagus	esophageal cancer
Tumour of lip	lip cancer
Congestive cardiac failure	congestive heart failure
Estrogen Receptor-positive Breast Cancer	estrogen-receptor positive breast cancer
Neutrophilic leukemia	chronic neutrophilic leukemia
Astrocytoma/Oligodendroglioma	mixed oligodendroglioma-astrocytoma
BRAF mutated colorectal cancer	colorectal cancer
Juvenile myelomonocytic leukaemia	juvenile myelomonocytic leukemia
Human epidermal growth factor 2 negative carcinoma of breast	breast carcinoma
Malignant tumour of prostate	prostate cancer
Neoplasm of biliary tract	biliary tract neoplasm
TB - Tuberculosis	tuberculosis
Carcinoma in situ	cancer
Primary intraocular non-Hodgkin malignant lymphoma	intraocular lymphoma
Type B viral hepatitis	hepatitis B
APL - Acute promyelocytic leukaemia	acute promyelocytic leukemia
RAEB-T - Refractory anaemia with excess blasts in transformation	anemia
Local recurrence of malignant tumor of pancreas	pancreas cancer
Erythroid aplasia	myelodysplastic syndrome
Non-small cell carcinoma of lung, TNM stage 2	non-small cell lung carcinoma
Neoplasm of pancreas	pancreatic carcinoma
Colitis gravis	colitis
Ewing sarcoma of bone	Ewing sarcoma
Extensive Stage Small Cell Lung Cancer	non-small cell lung carcinoma
Peripheral neuroectodermal tumour	neuroectodermal tumor
Inflammatory carcinoma of breast	inflammatory breast carcinoma
Non-small cell carcinoma of lung, TNM stage 1	non-small cell lung carcinoma
Germ cell tumor of ovary	ovarian germ cell cancer
Carcinoid tumor	gastrointestinal system cancer
Neoplasm of major salivary gland	salivary gland cancer
Cholangiocarcinoma of biliary tract	biliary tract cancer
NF - Neurofibromatosis	neurofibromatosis
Primitive neuroectodermal tumor	neuroectodermal tumor
Metastatic castration resistant prostate cancer	prostate cancer
Neoplasm of liver	liver cancer
Oligodendroglioma of brain	brain oligodendroglioma
Cancer of salivary gland	salivary gland cancer
Metastatic tumour of bone	bone cancer
Neutropenic disorder	neutropenia
Post-transplantation lymphoproliferative syndrome	lymphoproliferative syndrome
Tumour of gastrointestinal tract	gastrointestinal system cancer
Intraductal carcinoma in situ of breast	breast carcinoma in situ
Large cell carcinoma of lung	lung large cell carcinoma
Acute eosinophilic leukemia	acute leukemia
Basophilic leukemia	basophilic carcinoma
MM - Malignant melanoma of eye	ocular melanoma
Neoplasm of common bile duct	common bile duct neoplasm
Neoplasm of gallbladder	gallbladder cancer
Refractory anemia with sideroblasts	Refractory anemia with ringed sideroblasts
EGFR mutated GBM	glioblastoma multiforme
HIV associated Hodgkin Lymphoma	non-Hodgkin lymphoma
Hepatosplenic T-cell lymphoma	T-cell lymphoma
Neoplasm of small intestine	small intestine neoplasm
Neoplasm of stomach	Neoplasm of the stomach
Malignant tumour of small bowel	small bowel fibrosarcoma
Peripheral arterial occlusive disease	peripheral vascular disease
Squamous cell carcinoma of oesophagus	esophagus squamous cell carcinoma
Metastatic squamous cell carcinoma	squamous cell carcinoma
Neoplasm of peripheral nerves of thorax	peripheral nerve sheath neoplasm
Local recurrence of malignant tumor of esophagus	esophageal cancer
Primary central nervous system lymphoma	central nervous system lymphoma
Adenoid Cystic Carcinoma	lung adenoid cystic carcinoma
Plasma cell myeloma/plasmacytoma	multiple myeloma
Adenocarcinoma of prostate	prostate adenocarcinoma
Neoplasm of extrahepatic bile ducts	biliary tract neoplasm
Neoplasm of meninges	spinal meninges cancer
Tumor of endocrine pancreas	pancreatic endocrine carcinoma
Local recurrence of malignant tumour of urinary bladder	urinary bladder cancer
Refractory cytopenia with multilineage dysplasia	cytopenia
Primary malignant neoplasm of bone	bone cancer
Tumour of tongue	tongue cancer
ER+ HER2- PIK3CA Breast cancer	Her2-receptor negative breast cancer
Histiocytic syndrome	malignant histiocytic disease
Local recurrence of malignant tumour of cervix	cervix carcinoma
Mast cell leukaemia	mast-cell leukemia
Metastatic malignant melanoma	melanoma
Neoplasm of urethra	urethral benign neoplasm
Benign adenomatous neoplasm	benign neoplasm
Infiltrating lobular carcinoma of breast	breast cancer
Local recurrence of malignant tumor of gallbladder	gallbladder sarcoma
Malignant peripheral nerve sheath tumour	malignant melanocytic neoplasm of the peripheral nerve sheath
Mature B-cell leukaemia Burkitt-type	Burkitt lymphoma
Primary cutaneous T-cell lymphoma	cutaneous T cell lymphoma
Uterine sarcoma	uterine corpus sarcoma
Acute myeloid leukaemia with multilineage dysplasia	acute leukemia
Adenocarcinoma of endometrium	endometrial adenocarcinoma
Childhood myelodysplastic syndrome	myelodysplastic syndrome
Fanconi's hypoplastic anaemia	Fanconi anemia
Malignant lymphoma - lymphoplasmacytic	lymphoplasmacytic lymphoma
Trabecular cell carcinoma of skin	Merkel cell carcinoma
Endometrium	endometrial cancer
Pancreas	Pancreatic Cancer
Bladder	bladder cancer
Stomach	stomach cancer
Glioma	malignant glioma
Glioblastoma	glioblastoma classical subtype
Neoplasm of the larynx	larynx neoplasm
Neoplasm of the head and neck	head and neck neoplasm
Anaplastic thyroid carcinoma	thyroid carcinoma
Myelodysplasia	myelodysplastic syndrome
Single lineage myelodysplasia	myelodysplastic syndrome
Congenital neutropenia	neutropenia
Neoplasm of the colon	colon neoplasm
Cutaneous leiomyoma	leiomyoma cutis
Myelodisplasic syndrome	myelodisplastic syndrome
COADREAD	Colorectal adenocarcinoma
DLBC	diffuse large B-cell lymphoma
KIRC	Kidney Chromophobe
KIRP	clear cell renal cell carcinoma
LGG	Brain Glioma
LIHC	hepatocellular carcinoma
MESO	benign mesothelioma
PCPG	adrenal gland pheochromocytoma;Paraganglioma
SKCM	skin melanoma
TGCT	testicular germ cell cancer
